---------------------------------
---------------------------------
---------------------------------
---------------------------------
---------------------------------
---------------------------------
----------------------!----------
---------------------------------
---------------------------------
---------------------------------
----------------!---S@S!S--------
---------------------------------
----------------------------<>---
gykrM-----------------------[]-#-
XXXXXXXXXXXXXXXXXXXXXXXXXXXXXXXXX
XXXXXXXXXXXXXXXXXXXXXXXXXXXXXXXXX