------------
------------
------------
------------
------------
------------
------------
------------
------------
------------
------------
--------#---
----<>--#---
-M--[]-##---
XXXXXXXXXXXX
XXXXXXXXXXXX